EA textures/east.png
NO textures/north.png
SO textures/south.png
WE textures/west.png

F 4, 169, 7
C 2, 49, 133

        1111111111111111111111111
        1000000000110000000000001
        1111000001110000010000001
        10010000000100000S0000001
111111111011000001110000000100001
100000000011111111110111111111111
11110111111      11101110000001
111101111111111111000100000011
110000001101010111000000100011
100000000000000011000000100011
100000000000000011010100110011
110000001001010010001110100111
11110111 1110101 1011110100011
11111111 1111111 1111111111111
